 -1 -1 -1 -1 -1 -1 -1 -1 -1 -1 -1 -1 -1 -1 -1 -1 -1 -1 -1 -1 -1 -1 -1 -1 -1 -1 -1 -1 -1 -1 -1 -1 -1 -1 -1 -1 -1 -1 -1 -1 -1 -1 -1 -1 -1 -1 -1 -1 -1 -1 -1 -1
 -1  1  0  0 -1 -1 -1  0  0  0  0  0  0  0 -1 -1 -1  0  0  0  0  0 -1 -1 -1 -1 -1 -1  0 -1 -1 -1  0 -1 -1  0  0 -1 -1  0  0 -1  0  0  0  0  0  0 -1 -1  0 -1
 -1  0  0  0  0  0  0  0 -1  0  0 -1  0  0  0 -1 -1 -1 -1 -1 -1 -1  0  0  0  0  0  0  0  0  0  0 -1  0  0  0  0 -1 -1 -1  0 -1 -1 -1 -1 -1 -1 -1 -1  0 -1 -1
 -1  0 -1  0  0 -1  0  0 -1 -1 -1 -1  0 -1  0  0  0  0  0  0 -1 -1 -1  0 -1  0 -1 -1 -1 -1  0 -1 -1  0  0 -1  0  0  0  0  0 -1  0  0  0  0  0  0  0  0 -1 -1
 -1  0 -1  0 -1 -1  0  0  0  0 -1  0  0  0  0 -1  0 -1 -1  0 -1 -1 -1  0 -1  0  0 -1  0 -1 -1 -1 -1  0  0 -1 -1 -1 -1 -1  0 -1 -1  0 -1  0 -1  0  0 -1  0 -1
 -1  0 -1  0  0 -1 -1 -1 -1 -1 -1 -1 -1 -1  0 -1  0  0  0  0  0  0  0  0 -1 -1 -1 -1 -1 -1 -1 -1 -1  0  0  0 -1  0  0  0  0  0 -1  0 -1  0 -1 -1  0 -1 -1 -1
 -1  0 -1  0 -1 -1  0 -1 -1 -1  0 -1 -1 -1  0  0 -1  0 -1 -1 -1 -1 -1  0  0  0  0  0 -1 -1  0  0  0 -1  0  0 -1  0  0 -1 -1  0 -1  0  0  0 -1 -1  0 -1  0 -1
 -1  0 -1  0 -1 -1  0 -1  0  0  0  0 -1  0  0 -1 -1  0  0  0  0  0  0 -1  0  0 -1 -1  0  0  0 -1  0 -1  0  0 -1  0 -1 -1  0 -1 -1 -1  0 -1 -1  0  0  0  0 -1
 -1  0 -1  0 -1 -1  0 -1  0 -1 -1 -1 -1 -1  0  0  0 -1  0  0  0  0 -1 -1 -1  0 -1 -1  0 -1  0 -1  0 -1 -1  0 -1  0 -1 -1 -1  0  0 -1  0 -1 -1 -1  0 -1 -1 -1
 -1  0  0  0  0  0  0  0  0  0  0 -1 -1 -1  0 -1 -1 -1 -1 -1 -1 -1 -1 -1 -1 -1 -1 -1  0 -1  0 -1  0  0 -1  0  0  0  0  0 -1  0 -1 -1  0  0  0  0  0 -1 -1 -1
 -1 -1 -1 -1  0  0 -1 -1 -1  0 -1  0 -1  0  0  0  0 -1 -1 -1 -1  0  0 -1 -1 -1 -1 -1 -1 -1  0 -1  0 -1 -1  0 -1 -1 -1 -1 -1 -1  0 -1  0 -1 -1 -1 -1  0 -1 -1
 -1  0  0 -1  0  0 -1  0  0  0 -1 -1 -1 -1 -1  0  0  0  0  0  0  0  0  0 -1  0  0 -1 -1  0  0 -1  0  0  0  0  0  0 -1 -1  0  0 -1 -1  0  0  0  0  0 -1 -1 -1
 -1  0  0 -1 -1 -1 -1  0 -1 -1 -1 -1  0  0 -1 -1  0  0 -1 -1 -1 -1 -1  0 -1  0  0  0 -1  0  0  0  0 -1 -1 -1 -1 -1  0 -1  0  0 -1  0  0 -1  0 -1 -1  0 -1 -1
 -1 -1  0 -1 -1  0  0  0 -1 -1  0  0  0  0  0 -1  0  0 -1  0  0  0  0  0 -1  0 -1  0 -1 -1 -1  0  0  0  0  0  0 -1 -1 -1  0  0 -1  0  0  0  0 -1 -1 -1 -1 -1
 -1 -1 -1  0 -1  0 -1 -1 -1 -1 -1  0  0 -1  0 -1  0  0 -1 -1  0  0 -1  0 -1  0 -1  0 -1 -1 -1 -1 -1 -1  0 -1 -1  0  0  0 -1  0  0  0 -1  0 -1 -1  0 -1 -1 -1
 -1 -1 -1 -1 -1  0 -1 -1  0  0 -1  0  0 -1  0 -1  0  0 -1 -1  0 -1 -1  0 -1  0 -1  0  0  0 -1  0  0  0  0 -1 -1  0  0 -1 -1 -1 -1  0 -1 -1 -1 -1 -1 -1 -1 -1
 -1  0  0  0 -1 -1 -1 -1  0 -1 -1  0  0  0  0 -1 -1 -1  0 -1 -1 -1  0  0 -1  0 -1  0 -1 -1 -1 -1  0 -1  0  0  0 -1 -1  0 -1 -1 -1 -1  0  0  0  0  0 -1 -1 -1
 -1 -1  0  0  0 -1  0 -1 -1 -1 -1  0  0 -1 -1  0  0  0  0 -1 -1  0  0  0 -1  0 -1  0  0  0  0  0  0 -1  0 -1  0 -1 -1  0  0 -1  0  0  0 -1 -1 -1 -1 -1 -1 -1
 -1  0  0 -1  0 -1 -1 -1 -1  0 -1  0  0 -1  0  0 -1  0 -1 -1 -1 -1 -1  0 -1  0  0  0 -1  0  0 -1  0  0  0  0  0  0 -1 -1  0 -1 -1 -1 -1  0  0  0  0 -1  0 -1
 -1 -1  0 -1 -1 -1  0 -1 -1  0 -1  0  0 -1  0  0 -1  0 -1  0 -1  0  0  0 -1  0  0 -1 -1  0  0 -1  0  0 -1 -1  0  0  0  0  0  0  0  0  0  0  0 -1  0 -1  0 -1
 -1 -1 -1 -1 -1 -1 -1 -1 -1  0  0  0  0 -1  0  0 -1  0 -1  0 -1 -1 -1  0 -1 -1  0 -1  0  0  0  0  0  0 -1 -1 -1  0 -1 -1  0  0  0  0  0 -1  0 -1  0 -1  0 -1
 -1 -1 -1 -1  0  0 -1 -1  0 -1 -1  0  0 -1  0  0 -1  0 -1  0 -1  0  0  0 -1 -1  0  0  0 -1 -1 -1 -1  0  0 -1 -1  0  0 -1  0 -1 -1 -1  0 -1 -1 -1 -1 -1 -1 -1
 -1 -1 -1  0  0  0  0  0 -1 -1 -1  0  0 -1  0  0  0  0 -1  0 -1 -1 -1  0  0  0 -1  0  0  0  0  0 -1  0 -1  0 -1  0  0 -1 -1 -1 -1  0  0  0  0 -1  0 -1  0 -1
 -1  0  0  0  0 -1 -1  0 -1  0  0  0  0  0  0 -1 -1 -1 -1  0  0  0 -1 -1 -1  0 -1 -1 -1 -1 -1 -1 -1  0  0  0 -1  0  0 -1  0 -1 -1 -1 -1 -1  0 -1 -1  0  0 -1
 -1  0 -1 -1  0  0 -1  0 -1  0 -1  0 -1 -1 -1  0  0 -1  0  0 -1 -1 -1  0  0  0 -1  0  0  0  0  0 -1 -1 -1 -1 -1  0 -1 -1 -1  0  0  0 -1 -1  0  0 -1  0  0 -1
 -1 -1  0  0  0  0 -1  0  0  0  0  0 -1 -1 -1 -1 -1  0 -1 -1  0 -1 -1  0  0  0 -1  0 -1 -1  0  0 -1 -1 -1 -1  0  0 -1  0 -1  0  0 -1 -1  0  0  0 -1  0 -1 -1
 -1 -1 -1  0 -1  0  0  0 -1 -1  0 -1 -1  0 -1 -1 -1 -1 -1 -1 -1  0  0 -1 -1  0 -1  0  0  0  0 -1 -1 -1  0  0  0 -1  0  0 -1 -1 -1  0  0 -1 -1  0  0  0 -1 -1
 -1 -1 -1  0 -1 -1  0 -1 -1  0 -1 -1 -1  0  0  0  0  0  0  0 -1 -1 -1  0  0  0 -1  0 -1 -1 -1 -1  0  0 -1  0  0 -1 -1  0  0  0  0  0 -1 -1 -1  0 -1 -1 -1 -1
 -1  0 -1  0 -1 -1 -1  0  0 -1  0 -1 -1  0 -1 -1 -1  0 -1  0 -1 -1 -1  0  0  0  0  0  0  0  0  0  0  0 -1  0  0 -1 -1  0 -1 -1 -1  0  0  0  0  0 -1 -1  0 -1
 -1 -1 -1  0 -1 -1  0 -1  0 -1 -1  0  0  0  0  0 -1  0  0  0 -1 -1  0 -1 -1 -1 -1  0 -1 -1 -1 -1 -1 -1 -1  0  0  0  0  0  0 -1 -1 -1 -1 -1 -1  0 -1  0  0 -1
 -1 -1  0  0  0 -1 -1 -1  0  0  0  0 -1 -1  0  0 -1  0 -1 -1  0 -1  0 -1 -1 -1 -1  0  0  0  0  0  0  0  0 -1 -1  0  0  0 -1 -1  0  0  0  0  0  0 -1  0  0 -1
 -1  0 -1 -1  0 -1  0  0  0  0  0 -1 -1 -1 -1  0 -1  0  0  0 -1 -1 -1 -1 -1  0 -1  0 -1  0 -1 -1  0 -1  0 -1 -1 -1  0  0 -1 -1 -1  0  0  0  0 -1 -1 -1  0 -1
 -1 -1  0  0  0 -1 -1  0  0 -1 -1 -1 -1 -1 -1  0 -1  0 -1  0 -1  0 -1  0 -1  0  0  0 -1  0  0  0  0 -1  0  0  0 -1 -1 -1  0 -1  0  0 -1 -1  0  0 -1 -1  0 -1
 -1 -1 -1  0  0 -1 -1 -1 -1 -1 -1  0  0 -1  0  0 -1  0 -1  0 -1  0  0 -1  0  0 -1 -1 -1 -1 -1  0  0 -1  0 -1  0  0  0  0  0 -1 -1  0 -1 -1  0  0 -1 -1  0 -1
 -1 -1 -1  0 -1 -1 -1  0 -1  0 -1 -1  0 -1  0  0 -1  0  0  0  0  0 -1 -1  0  0 -1  0  0  0  0  0 -1  0  0  0  0  0 -1 -1  0  0  0 -1 -1 -1  0  0 -1 -1  0 -1
 -1  0 -1  0 -1 -1 -1 -1 -1 -1  0 -1 -1  0 -1 -1 -1 -1 -1 -1 -1  0 -1 -1  0 -1 -1  0 -1 -1 -1  0 -1  0 -1 -1 -1  0  0  0  0 -1  0  0  0  0  0  0  0  0  0 -1
 -1  0 -1  0  0  0  0  0  0  0  0 -1 -1 -1 -1  0  0  0  0  0  0  0  0 -1  0 -1  0  0  0  0  0  0  0  0  0  0  0  0 -1 -1  0 -1  0 -1 -1 -1 -1 -1  0  0  0 -1
 -1  0 -1  0 -1 -1  0  0  0  0  0  0  0  0  0  0  0  0  0  0 -1 -1  0  0  0  0  0  0  0  0  0 -1 -1  0  0  0 -1  0 -1 -1  0  0  0  0  0  0  0 -1 -1  0 -1 -1
 -1 -1 -1  0  0  0  0 -1 -1  0 -1 -1 -1  0 -1 -1  0 -1 -1  0  0  0  0  0 -1  0 -1 -1 -1  0 -1 -1 -1 -1 -1  0  0  0  0 -1 -1  0 -1 -1 -1 -1  0 -1 -1  0  0 -1
 -1  0  0  0 -1  0  0 -1 -1  0  0  0  0  0 -1  0 -1 -1  0  0 -1  0  0  0 -1  0  0  0 -1  0 -1 -1  0  0 -1 -1 -1 -1  0  0 -1  0  0  0  0  0  0 -1 -1 -1 -1 -1
 -1 -1  0  0  0  0 -1  0  0  0 -1 -1 -1  0 -1 -1 -1  0  0  0 -1  0 -1 -1 -1  0  0 -1 -1  0  0  0 -1  0  0  0  0  0  0  0 -1  0 -1 -1 -1 -1  0  0  0 -1 -1 -1
 -1 -1  0  0  0 -1 -1  0 -1  0  0  0  0  0  0  0  0  0  0  0  0  0  0 -1 -1 -1 -1  0 -1  0 -1  0 -1  0 -1  0 -1 -1  0  0  0  0  0  0  0  0  0 -1  0 -1 -1 -1
 -1 -1 -1  0  0 -1  0  0  0  0  0 -1 -1 -1 -1  0  0 -1  0 -1 -1  0  0  0  0  0 -1  0 -1 -1  0  0 -1 -1 -1 -1 -1 -1  0 -1 -1  0 -1  0  0  0  0 -1  0  0  0 -1
 -1  0 -1 -1  0  0 -1 -1 -1 -1  0  0  0  0 -1 -1  0 -1 -1 -1  0 -1 -1 -1  0 -1 -1  0 -1 -1  0  0  0  0  0 -1  0  0  0 -1 -1 -1 -1  0 -1 -1  0 -1  0 -1  0 -1
 -1 -1  0  0 -1 -1 -1  0  0 -1  0  0 -1  0  0  0  0 -1 -1 -1  0 -1  0 -1  0 -1 -1  0 -1 -1 -1 -1 -1 -1  0  0  0  0  0  0  0  0  0  0 -1  0  0  0  0  0 -1 -1
 -1  0 -1  0  0  0 -1  0  0  0 -1 -1 -1 -1  0 -1  0  0  0  0 -1 -1  0 -1 -1  0  0 -1  0  0  0  0  0 -1 -1  0 -1 -1  0 -1 -1 -1 -1 -1 -1  0 -1 -1 -1  0  0 -1
 -1 -1  0  0  0  0 -1 -1  0  0 -1 -1  0 -1  0  0  0 -1 -1  0 -1 -1  0  0  0  0  0 -1 -1  0  0  0  0 -1 -1 -1  0 -1  0 -1 -1 -1  0  0  0  0 -1 -1 -1  0 -1 -1
 -1 -1 -1 -1  0  0 -1 -1  0  0  0  0  0 -1 -1 -1  0  0  0  0  0  0  0  0 -1 -1  0  0  0 -1 -1 -1 -1 -1  0  0  0 -1 -1 -1  0  0  0 -1 -1  0 -1 -1 -1  0  0 -1
 -1  0 -1  0 -1 -1  0 -1 -1  0  0  0  0 -1 -1 -1  0  0 -1 -1 -1  0 -1  0 -1  0  0 -1  0  0  0  0  0 -1 -1  0  0 -1  0 -1  0 -1  0 -1 -1 -1 -1 -1  0 -1  0 -1
 -1 -1 -1  0  0  0  0 -1 -1 -1 -1 -1  0 -1 -1 -1 -1  0  0  0  0  0 -1  0 -1 -1  0  0  0 -1  0  0  0  0 -1 -1 -1 -1  0 -1  0 -1  0  0  0  0 -1 -1  0  0  0 -1
 -1  0  0  0  0  0 -1 -1  0 -1 -1  0 -1  0 -1 -1 -1 -1 -1 -1 -1 -1  0  0 -1 -1 -1 -1  0  0  0 -1 -1 -1 -1  0 -1  0  0 -1  0 -1  0  0  0  0  0  0  0  0  1 -1
 -1 -1 -1 -1 -1 -1 -1 -1 -1 -1 -1 -1 -1 -1 -1 -1 -1 -1 -1 -1 -1 -1 -1 -1 -1 -1 -1 -1 -1 -1 -1 -1 -1 -1 -1 -1 -1 -1 -1 -1 -1 -1 -1 -1 -1 -1 -1 -1 -1 -1 -1 -1
  0  0  0  0  0  0  0  0  0  0  0  0  0  0  0  0  0  0  0  0  0  0  0  0  0  0  0  0  0  0  0  0  0  0  0  0  0  0  0  0  0  0  0  0  0  0  0  0  0  0  0  0
  0  0  1  2  0  0  0  8  9 10 11 12 13 14  0  0  0  0  0  0  0  0  0  0  0  0  0  0  0  0  0  0  0  0  0  0  0  0  0  0  0  0  0  0  0  0  0  0  0  0  0  0
  0  0  0  3  4  5  6  7  0  0  0  0  0 15 16  0  0  0  0  0  0  0  0  0  0  0  0  0  0  0  0  0  0  0  0  0  0  0  0  0  0  0  0  0  0  0  0  0  0  0  0  0
  0  0  0  0  0  0  0  0  0  0  0  0  0  0 17  0  0  0  0  0  0  0  0  0  0  0  0  0  0  0  0  0  0  0  0  0  0  0  0  0  0  0  0  0  0  0  0  0  0  0  0  0
  0  0  0  0  0  0  0  0  0  0  0  0  0  0 18  0  0  0  0  0  0  0  0  0  0  0  0  0  0  0  0  0  0  0  0  0  0  0  0  0  0  0  0  0  0  0  0  0  0  0  0  0
  0  0  0  0  0  0  0  0  0  0  0  0  0  0 19  0  0  0  0  0  0  0  0  0  0  0  0  0  0  0  0  0  0  0  0  0  0  0  0  0  0  0  0  0  0  0  0  0  0  0  0  0
  0  0  0  0  0  0  0  0  0  0  0  0  0  0 20  0  0  0  0  0  0  0  0  0  0  0  0  0  0  0  0  0  0  0  0  0  0  0  0  0  0  0  0  0  0  0  0  0  0  0  0  0
  0  0  0  0  0  0  0  0  0  0  0  0  0  0 21  0  0  0  0  0  0  0  0  0  0  0  0  0  0  0  0  0  0  0  0  0  0  0  0  0  0  0  0  0  0  0  0  0  0  0  0  0
  0  0  0  0  0  0  0  0  0  0  0  0  0  0 22  0  0  0  0  0  0  0  0  0  0  0  0  0  0  0  0  0  0  0  0  0  0  0  0  0  0  0  0  0  0  0  0  0  0  0  0  0
  0  0  0  0  0  0  0  0  0  0  0  0  0  0 23  0  0  0  0  0  0  0  0  0  0  0  0  0  0  0  0  0  0  0  0  0  0  0  0  0  0  0  0  0  0  0  0  0  0  0  0  0
  0  0  0  0  0  0  0  0  0  0  0  0  0  0 24 25 26  0  0  0  0  0  0  0  0  0  0  0  0  0  0  0  0  0  0  0  0  0  0  0  0  0  0  0  0  0  0  0  0  0  0  0
  0  0  0  0  0  0  0  0  0  0  0  0  0  0  0  0 27 28 29 30 31 32 33 34  0  0  0  0  0  0  0  0  0  0  0  0  0  0  0  0  0  0  0  0  0  0  0  0  0  0  0  0
  0  0  0  0  0  0  0  0  0  0  0  0  0  0  0  0  0  0  0  0  0  0  0 35  0  0  0  0  0  0  0  0  0  0  0  0  0  0  0  0  0  0  0  0  0  0  0  0  0  0  0  0
  0  0  0  0  0  0  0  0  0  0  0  0  0  0  0  0  0  0  0  0  0  0  0 36  0  0  0  0  0  0  0  0  0  0  0  0  0  0  0  0  0  0  0  0  0  0  0  0  0  0  0  0
  0  0  0  0  0  0  0  0  0  0  0  0  0  0  0  0  0  0  0  0  0  0  0 37  0  0  0  0  0  0  0  0  0  0  0  0  0  0  0  0  0  0  0  0  0  0  0  0  0  0  0  0
  0  0  0  0  0  0  0  0  0  0  0  0  0  0  0  0  0  0  0  0  0  0  0 38  0  0  0  0  0  0  0  0  0  0  0  0  0  0  0  0  0  0  0  0  0  0  0  0  0  0  0  0
  0  0  0  0  0  0  0  0  0  0  0  0  0  0  0  0  0  0  0  0  0  0  0 39  0  0  0  0  0  0  0  0  0  0  0  0  0  0  0  0  0  0  0  0  0  0  0  0  0  0  0  0
  0  0  0  0  0  0  0  0  0  0  0  0  0  0  0  0  0  0  0  0  0  0  0 40  0  0  0  0  0  0  0  0  0  0  0  0  0  0  0  0  0  0  0  0  0  0  0  0  0  0  0  0
  0  0  0  0  0  0  0  0  0  0  0  0  0  0  0  0  0  0  0  0  0  0  0 41  0  0  0  0  0  0  0  0  0  0  0  0  0  0  0  0  0  0  0  0  0  0  0  0  0  0  0  0
  0  0  0  0  0  0  0  0  0  0  0  0  0  0  0  0  0  0  0  0  0  0  0 42  0  0  0  0  0  0  0  0  0  0  0  0  0  0  0  0  0  0  0  0  0  0  0  0  0  0  0  0
  0  0  0  0  0  0  0  0  0  0  0  0  0  0  0  0  0  0  0  0  0  0  0 43  0  0  0  0  0  0  0  0  0  0  0  0  0  0  0  0  0  0  0  0  0  0  0  0  0  0  0  0
  0  0  0  0  0  0  0  0  0  0  0  0  0  0  0  0  0  0  0  0  0  0  0 44  0  0  0  0  0  0  0  0  0  0  0  0  0  0  0  0  0  0  0  0  0  0  0  0  0  0  0  0
  0  0  0  0  0  0  0  0  0  0  0  0  0  0  0  0  0  0  0  0  0  0  0 45 46 47  0  0  0  0  0  0  0  0  0  0  0  0  0  0  0  0  0  0  0  0  0  0  0  0  0  0
  0  0  0  0  0  0  0  0  0  0  0  0  0  0  0  0  0  0  0  0  0  0  0  0  0 48  0  0  0  0  0  0  0  0  0  0  0  0  0  0  0  0  0  0  0  0  0  0  0  0  0  0
  0  0  0  0  0  0  0  0  0  0  0  0  0  0  0  0  0  0  0  0  0  0  0  0  0 49  0  0  0  0  0  0  0  0  0  0  0  0  0  0  0  0  0  0  0  0  0  0  0  0  0  0
  0  0  0  0  0  0  0  0  0  0  0  0  0  0  0  0  0  0  0  0  0  0  0  0  0 50  0  0  0  0  0  0  0  0  0  0  0  0  0  0  0  0  0  0  0  0  0  0  0  0  0  0
  0  0  0  0  0  0  0  0  0  0  0  0  0  0  0  0  0  0  0  0  0  0  0  0  0 51  0  0  0  0  0  0  0  0  0  0  0  0  0  0  0  0  0  0  0  0  0  0  0  0  0  0
  0  0  0  0  0  0  0  0  0  0  0  0  0  0  0  0  0  0  0  0  0  0  0  0  0 52  0  0  0  0  0  0  0  0  0  0  0  0  0  0  0  0  0  0  0  0  0  0  0  0  0  0
  0  0  0  0  0  0  0  0  0  0  0  0  0  0  0  0  0  0  0  0  0  0  0  0  0 53 54 55  0  0  0  0  0  0  0  0  0  0  0  0  0  0  0  0  0  0  0  0  0  0  0  0
  0  0  0  0  0  0  0  0  0  0  0  0  0  0  0  0  0  0  0  0  0  0  0  0  0  0  0 56  0  0  0  0  0  0  0  0  0  0  0  0  0  0  0  0  0  0  0  0  0  0  0  0
  0  0  0  0  0  0  0  0  0  0  0  0  0  0  0  0  0  0  0  0  0  0  0  0  0  0  0 57 58 59 60 61 62 63 64  0  0  0  0  0  0  0  0  0  0  0  0  0  0  0  0  0
  0  0  0  0  0  0  0  0  0  0  0  0  0  0  0  0  0  0  0  0  0  0  0  0  0  0  0  0  0  0  0  0  0  0 65  0  0  0  0  0  0  0  0  0  0  0  0  0  0  0  0  0
  0  0  0  0  0  0  0  0  0  0  0  0  0  0  0  0  0  0  0  0  0  0  0  0  0  0  0  0  0  0  0  0  0  0 66 67 68  0  0  0  0  0  0  0  0  0  0  0  0  0  0  0
  0  0  0  0  0  0  0  0  0  0  0  0  0  0  0  0  0  0  0  0  0  0  0  0  0  0  0  0  0  0  0  0  0  0  0  0 69 70 71 72 73  0  0  0  0  0  0  0  0  0  0  0
  0  0  0  0  0  0  0  0  0  0  0  0  0  0  0  0  0  0  0  0  0  0  0  0  0  0  0  0  0  0  0  0  0  0  0  0  0  0  0  0 74 75 76  0  0  0  0  0  0  0  0  0
  0  0  0  0  0  0  0  0  0  0  0  0  0  0  0  0  0  0  0  0  0  0  0  0  0  0  0  0  0  0  0  0  0  0  0  0  0  0  0  0  0  0 77  0  0  0  0  0  0  0  0  0
  0  0  0  0  0  0  0  0  0  0  0  0  0  0  0  0  0  0  0  0  0  0  0  0  0  0  0  0  0  0  0  0  0  0  0  0  0  0  0  0  0  0 78  0  0  0  0  0  0  0  0  0
  0  0  0  0  0  0  0  0  0  0  0  0  0  0  0  0  0  0  0  0  0  0  0  0  0  0  0  0  0  0  0  0  0  0  0  0  0  0  0  0  0  0 79 80 81 82 83  0  0  0  0  0
  0  0  0  0  0  0  0  0  0  0  0  0  0  0  0  0  0  0  0  0  0  0  0  0  0  0  0  0  0  0  0  0  0  0  0  0  0  0  0  0  0  0  0  0  0  0 84  0  0  0  0  0
  0  0  0  0  0  0  0  0  0  0  0  0  0  0  0  0  0  0  0  0  0  0  0  0  0  0  0  0  0  0  0  0  0  0  0  0  0  0  0  0  0  0  0  0  0  0 85  0  0  0  0  0
  0  0  0  0  0  0  0  0  0  0  0  0  0  0  0  0  0  0  0  0  0  0  0  0  0  0  0  0  0  0  0  0  0  0  0  0  0  0  0  0  0  0  0  0  0  0 86 87 88  0  0  0
  0  0  0  0  0  0  0  0  0  0  0  0  0  0  0  0  0  0  0  0  0  0  0  0  0  0  0  0  0  0  0  0  0  0  0  0  0  0  0  0  0  0  0  0  0  0  0  0 89  0  0  0
  0  0  0  0  0  0  0  0  0  0  0  0  0  0  0  0  0  0  0  0  0  0  0  0  0  0  0  0  0  0  0  0  0  0  0  0  0  0  0  0  0  0  0  0  0  0  0  0 90  0  0  0
  0  0  0  0  0  0  0  0  0  0  0  0  0  0  0  0  0  0  0  0  0  0  0  0  0  0  0  0  0  0  0  0  0  0  0  0  0  0  0  0  0  0  0  0  0  0  0  0 91  0  0  0
  0  0  0  0  0  0  0  0  0  0  0  0  0  0  0  0  0  0  0  0  0  0  0  0  0  0  0  0  0  0  0  0  0  0  0  0  0  0  0  0  0  0  0  0  0  0  0  0 92 93  0  0
  0  0  0  0  0  0  0  0  0  0  0  0  0  0  0  0  0  0  0  0  0  0  0  0  0  0  0  0  0  0  0  0  0  0  0  0  0  0  0  0  0  0  0  0  0  0  0  0  0 94  0  0
  0  0  0  0  0  0  0  0  0  0  0  0  0  0  0  0  0  0  0  0  0  0  0  0  0  0  0  0  0  0  0  0  0  0  0  0  0  0  0  0  0  0  0  0  0  0  0  0  0 95  0  0
  0  0  0  0  0  0  0  0  0  0  0  0  0  0  0  0  0  0  0  0  0  0  0  0  0  0  0  0  0  0  0  0  0  0  0  0  0  0  0  0  0  0  0  0  0  0  0  0  0 96 97  0
  0  0  0  0  0  0  0  0  0  0  0  0  0  0  0  0  0  0  0  0  0  0  0  0  0  0  0  0  0  0  0  0  0  0  0  0  0  0  0  0  0  0  0  0  0  0  0  0  0  0 98  0
  0  0  0  0  0  0  0  0  0  0  0  0  0  0  0  0  0  0  0  0  0  0  0  0  0  0  0  0  0  0  0  0  0  0  0  0  0  0  0  0  0  0  0  0  0  0  0  0  0  0 99  0
  0  0  0  0  0  0  0  0  0  0  0  0  0  0  0  0  0  0  0  0  0  0  0  0  0  0  0  0  0  0  0  0  0  0  0  0  0  0  0  0  0  0  0  0  0  0  0  0  0  0100  0
  0  0  0  0  0  0  0  0  0  0  0  0  0  0  0  0  0  0  0  0  0  0  0  0  0  0  0  0  0  0  0  0  0  0  0  0  0  0  0  0  0  0  0  0  0  0  0  0  0  0  0  0
